..........
..!!!!!!..
..!....!..
..!.S.....
..!....!..
..!!!!!!..
..........
......E...